000000020202020000011110000000020222220000
202222000002020222211110022220020000020222
000000022222020000111111000020020222020222
022220020000000011111111110020020002000000
020020020202220111111111111022022202222022
020020000200200111111111111000000200002000
022020020202111111111111111110020222202222
000022220202111111100001111111000000000000
020020000211111111222200011111110222022222
022222200011111100200002201111110202020000
000200001111111100222200000011110202022022
002211111111111100000202220001110000000000
221111111111111110220202000001111102222020
111111001111111111000200011111111100002020
111111001111111111110000111111111111102020
111110022201111111111111111111101111102222
111200020201111111111111111111202111100000
110202220201111111101111111111202211110220
002200020221111111000111111111202111111020
222002220001111110000011111111111111111022
000002001111111111000111111110000011111100
220222011111111111101111111110222211111111
000020011112221111111111111222200211111111
022220011100021111111111111200000211100111
020000211112221111111111110202220222000011
020022220111111111111111112202020020222011
000020020111111112221111110002000220202011
102020000000011100000011112202220200002011
102022220022011100220011110200000002222011
111000020020011120022011110222220220001111
111022000000011112002011111120000201111111
111112011111111111100011111122222211112222
011112011111111111110011111100000011122000
002111111111111111111111111111111111120020
002111111111111111111111111111111111100020
011110011111111100000000011111111111122000
111110211111111002220222000111110001112222
111110001111112000000202022111102020111111
111000001111122020000202000201102020111111
111022022201020020222202220201102020000111
100000000200000000200000020200022022002011
102200220000020220002202000002000000200011